5
5
11111
10001
10001
10301
11111