7
7
1111111
1002001
1000001
1000001
1000001
1003001
1111111